
EA ./Textures/universe.xpm
WE ./Textures/universe1.xpm
NO ./Textures/universe.xpm
SO ./Textures/universe1.xpm

F 20,5,0
C 0, 0,20

1111111111111111111111111111111
100000000000001 100000000000001
10000011100000111000000000011111
1000000010000010000000000000000011111
10100000010001000000000001000000000001
     100000111000000100000000000111001
     100000111101111100000000000000001 
     101000000000000000000000010001111
1111101111011111000000000000111111
100000111000001110000000000001001
101000000000000000000000010000001
10111000001010000000000001010S001
10000011100000      1110010000001
1111111111111111111111111111111111
