R 1000 1000

NO ./Textures/abstract-beauty.xpm
SO ./Textures/abstract-beauty.xpm
EA ./Textures/abstract.xpm
WE ./Textures/abstract.xpm
S ./Textures/arbre.xpm
 
C 121,248,248
F 246, 254, 254

1111111111111111111111111111
1000000000000000000000000001
1000001110000011100000000001
1000000010000010000011100001
1010000000020011000000000101
1011100011100000000000011101
10000111000N0000002000000001
1010000000000111000011000101
1011100000101000000001000001
1000001110000011100001000001
1010000001110000000001020101
1011100000100000000001000001
1000001110000011100000000001
1111111111111111111111111111
