R 1000 1000

NO ./Textures/universe1.xpm
SO ./Textures/universe1.xpm
EA ./Textures/universe.xpm
WE ./Textures/universe.xpm
S ./Textures/smoke.xpm

F 20,5,0
C 0,0,20
 
1111111111111111111111111111
1000000000000000000000000001
1002001110000011100000000001
1000000010000010000000000001
1010000000000020000000000101
1011100000200000002000011101
10002000000N0000200000000001
1010000000200002000020000101
1011100000101000000000000001
1000001110000011100000000001
1010000000002000000002000101
1011100200101000000000000001
1000001110000011100000000001
1111111111111111111111111111
