R 1000 1000

NO ./Textures/abstract-beauty.xpm
SO ./Textures/abstract-beauty.xpm
EA ./Textures/abstract.xpm
WE ./Textures/abstract.xpm
S ./Textures/arbre.xpm
 
C 121,248,248
F 246, 254, 254

1111111111111111111111111111
1000000000000000000000000001
1000001110000011100000000001
1000000010000010000000000001
1010000000020000000000000101
1011100000000000000000011101
10000000000N0000002000000001
1010000000000000000000000101
1011100000101000000000000001
1000001110000011100000000001
1010000000000000000000020101
1011100000101000000000000001
1000001110000011100000000001
1111111111111111111111111111
