R 1000 1000

NO ./Textures/universe1.xpm
SO ./Textures/universe1.xpm
EA ./Textures/universe.xpm
WE ./Textures/universe.xpm
S ./Textures/smoke.xpm

F 20,5,0
C 0,0,20
 
1111111111111111111111111111
1000110000000000000000000001
1002001110000011100000000001
1000000010000010001100020001
1010011000000000000000000101
1011100020000110000000011101
10000000000N0000000011000001
1010010000100002000100000101
1011100000111000000111100001
1000001110000011100100000001
1010000000000000000002000101
1011100200101000011000110001
1000001110000011100000000001
1111111111111111111111111111
